28x36
-1 -1 -1 -1 -1 -1 -1 -1 -1 -1 -1 -1 -1 -1 -1 -1 -1 -1 -1 -1 -1 -1 -1 -1 -1 -1 -1 -1
-1 -1 -1 -1 -1 -1 -1 -1 -1 -1 -1 -1 -1 -1 -1 -1 -1 -1 -1 -1 -1 -1 -1 -1 -1 -1 -1 -1
0 4 4 4 4 4 4 4 4 4 4 4 4 9 9 4 4 4 4 4 4 4 4 4 4 4 4 1
5 -1 -1 -1 -1 -1 -1 -1 -1 -1 -1 -1 -1 5 5 -1 -1 -1 -1 -1 -1 -1 -1 -1 -1 -1 -1 5
5 -1 0 4 4 1 -1 0 4 4 4 1 -1 5 5 -1 0 4 4 4 1 -1 0 4 4 1 -1 5
5 19 5 -1 -1 5 -1 5 -1 -1 -1 5 -1 5 5 -1 5 -1 -1 -1 5 -1 5 -1 -1 5 19 5
5 -1 2 4 4 3 -1 2 4 4 4 3 -1 2 3 -1 2 4 4 4 3 -1 2 4 4 3 -1 5
5 -1 -1 -1 -1 -1 -1 -1 -1 -1 -1 -1 -1 -1 -1 -1 -1 -1 -1 -1 -1 -1 -1 -1 -1 -1 -1 5
5 -1 0 4 4 1 -1 0 1 -1 0 4 4 4 4 4 4 1 -1 0 1 -1 0 4 4 1 -1 5
5 -1 2 4 4 3 -1 5 5 -1 2 4 4 1 0 4 4 3 -1 5 5 -1 2 4 4 3 -1 5
5 -1 -1 -1 -1 -1 -1 5 5 -1 -1 -1 -1 5 5 -1 -1 -1 -1 5 5 -1 -1 -1 -1 -1 -1 5
10 4 4 4 4 1 -1 5 10 4 4 1 -1 5 5 -1 0 4 4 8 5 -1 0 4 4 4 4 8
5 -1 -1 -1 -1 5 -1 5 10 4 4 3 -1 2 3 -1 2 4 4 8 5 -1 5 -1 -1 -1 -1 5
5 -1 -1 -1 -1 5 -1 5 5 15 -1 -1 -1 -1 -1 -1 -1 -1 16 5 5 -1 5 -1 -1 -1 -1 5
5 -1 -1 -1 -1 5 -1 5 5 -1 0 4 4 4 4 4 4 1 -1 5 5 -1 5 -1 -1 -1 -1 5
2 4 4 4 4 3 -1 2 3 -1 5 -1 -1 -1 -1 -1 -1 5 -1 2 3 -1 2 4 4 4 4 3
-1 -1 -1 -1 -1 -1 -1 -1 -1 -1 5 -1 -1 -1 -1 -1 -1 5 -1 -1 -1 -1 -1 -1 -1 -1 -1 -1
0 4 4 4 4 1 -1 0 1 -1 5 -1 -1 -1 -1 -1 -1 5 -1 0 1 -1 0 4 4 4 4 1
5 -1 -1 -1 -1 5 -1 5 5 -1 2 4 4 4 4 4 4 3 -1 5 5 -1 5 -1 -1 -1 -1 5
5 -1 -1 -1 -1 5 -1 5 5 -1 -1 -1 -1 17 -1 -1 -1 -1 -1 5 5 -1 5 -1 -1 -1 -1 5
5 -1 -1 -1 -1 5 -1 5 5 -1 0 4 4 4 4 4 4 1 -1 5 5 -1 5 -1 -1 -1 -1 5
10 4 4 4 4 3 -1 2 3 -1 2 4 4 1 0 4 4 3 -1 2 3 -1 2 4 4 4 4 8
5 -1 -1 -1 -1 -1 -1 -1 -1 -1 -1 -1 -1 5 5 -1 -1 -1 -1 -1 -1 -1 -1 -1 -1 -1 -1 5
5 -1 0 4 4 1 -1 0 4 4 4 1 -1 5 5 -1 0 4 4 4 1 -1 0 4 4 1 -1 5
5 -1 2 4 1 5 -1 2 4 4 4 3 -1 2 3 -1 2 4 4 4 3 -1 5 0 4 3 -1 5
5 19 -1 -1 5 5 -1 -1 -1 -1 -1 -1 -1 -1 -1 -1 -1 -1 -1 -1 -1 -1 5 5 -1 -1 19 5
10 4 1 -1 5 5 -1 0 1 -1 0 4 4 4 4 4 4 1 -1 0 1 -1 5 5 -1 0 4 8
10 4 3 -1 2 3 -1 5 5 -1 2 4 4 1 0 4 4 3 -1 5 5 -1 2 3 -1 2 4 8
5 -1 -1 -1 -1 -1 -1 5 5 -1 -1 -1 -1 5 5 -1 -1 -1 -1 5 5 -1 -1 -1 -1 -1 -1 5
5 -1 0 4 4 4 4 3 2 4 4 1 -1 5 5 -1 0 4 4 3 2 4 4 4 4 1 -1 5
5 -1 2 4 4 4 4 4 4 4 4 3 -1 2 3 -1 2 4 4 4 4 4 4 4 4 3 -1 5
5 -1 -1 -1 -1 -1 -1 -1 -1 -1 -1 -1 -1 -1 -1 -1 -1 -1 -1 -1 -1 -1 -1 -1 -1 -1 -1 5
2 4 4 4 4 4 4 4 4 4 4 4 4 4 4 4 4 4 4 4 4 4 4 4 4 4 4 3
-1 -1 -1 -1 -1 -1 -1 -1 -1 -1 -1 -1 -1 -1 -1 -1 -1 -1 -1 -1 -1 -1 -1 -1 -1 -1 -1 -1
-1 -1 -1 -1 -1 -1 -1 -1 -1 -1 -1 -1 -1 -1 -1 -1 -1 -1 -1 -1 -1 -1 -1 -1 -1 -1 -1 -1
-1 -1 -1 -1 -1 -1 -1 -1 -1 -1 -1 -1 -1 -1 -1 -1 -1 -1 -1 -1 -1 -1 -1 -1 -1 -1 -1 -1
pacman 13 25
ghost   1  3
ghost  26  3
ghost   1 31
ghost  26 31