28x36
-1 -1 -1 -1 -1 -1 -1 -1 -1 -1 -1 -1 -1 -1 -1 -1 -1 -1 -1 -1 -1 -1 -1 -1 -1 -1 -1 -1
-1 -1 -1 -1 -1 -1 -1 -1 -1 -1 -1 -1 -1 -1 -1 -1 -1 -1 -1 -1 -1 -1 -1 -1 -1 -1 -1 -1
0 4 4 4 4 4 4 4 4 4 4 4 4 9 9 4 4 4 4 4 4 4 4 4 4 4 4 1
5 18 18 18 18 18 18 18 18 18 18 18 18 5 5 18 18 18 18 18 18 18 18 18 18 18 18 5
5 18 0 4 4 1 18 0 4 4 4 1 18 5 5 18 0 4 4 4 1 18 0 4 4 1 18 5
5 19 5 -1 -1 5 18 5 -1 -1 -1 5 18 5 5 18 5 -1 -1 -1 5 18 5 -1 -1 5 19 5
5 18 2 4 4 3 18 2 4 4 4 3 18 2 3 18 2 4 4 4 3 18 2 4 4 3 18 5
5 18 18 18 18 18 18 18 18 18 18 18 18 18 18 18 18 18 18 18 18 18 18 18 18 18 18 5
5 18 0 4 4 1 18 0 1 18 0 4 4 4 4 4 4 1 18 0 1 18 0 4 4 1 18 5
5 18 2 4 4 3 18 5 5 18 2 4 4 1 0 4 4 3 18 5 5 18 2 4 4 3 18 5
5 18 18 18 18 18 18 5 5 18 18 18 18 5 5 18 18 18 18 5 5 18 18 18 18 18 18 5
10 4 4 4 4 1 18 5 10 4 4 1 -1 5 5 -1 0 4 4 8 5 18 0 4 4 4 4 8
5 -1 -1 -1 -1 5 18 5 10 4 4 3 -1 2 3 -1 2 4 4 8 5 18 5 -1 -1 -1 -1 5
5 -1 -1 -1 -1 5 18 5 5 15 -1 -1 -1 -1 -1 -1 -1 -1 16 5 5 18 5 -1 -1 -1 -1 5
5 -1 -1 -1 -1 5 18 5 5 -1 0 4 4 4 4 4 4 1 -1 5 5 18 5 -1 -1 -1 -1 5
2 4 4 4 4 3 18 2 3 -1 5 -1 -1 -1 -1 -1 -1 5 -1 2 3 18 2 4 4 4 4 3
-1 -1 -1 -1 -1 -1 18 -1 -1 -1 5 -1 -1 -1 -1 -1 -1 5 -1 -1 -1 18 -1 -1 -1 -1 -1 -1
0 4 4 4 4 1 18 0 1 -1 5 -1 -1 -1 -1 -1 -1 5 -1 0 1 18 0 4 4 4 4 1
5 -1 -1 -1 -1 5 18 5 5 -1 2 4 4 4 4 4 4 3 -1 5 5 18 5 -1 -1 -1 -1 5
5 -1 -1 -1 -1 5 18 5 5 -1 -1 -1 -1 17 -1 -1 -1 -1 -1 5 5 18 5 -1 -1 -1 -1 5
5 -1 -1 -1 -1 5 18 5 5 -1 0 4 4 4 4 4 4 1 -1 5 5 18 5 -1 -1 -1 -1 5
10 4 4 4 4 3 18 2 3 -1 2 4 4 1 0 4 4 3 -1 2 3 18 2 4 4 4 4 8
5 18 18 18 18 18 18 18 18 18 18 18 18 5 5 18 18 18 18 18 18 18 18 18 18 18 18 5
5 18 0 4 4 1 18 0 4 4 4 1 18 5 5 18 0 4 4 4 1 18 0 4 4 1 18 5
5 18 2 4 1 5 18 2 4 4 4 3 18 2 3 18 2 4 4 4 3 18 5 0 4 3 18 5
5 19 18 18 5 5 18 18 18 18 18 18 18 18 18 18 18 18 18 18 18 18 5 5 18 18 19 5
10 4 1 18 5 5 18 0 1 18 0 4 4 4 4 4 4 1 18 0 1 18 5 5 18 0 4 8
10 4 3 18 2 3 18 5 5 18 2 4 4 1 0 4 4 3 18 5 5 18 2 3 18 2 4 8
5 18 18 18 18 18 18 5 5 18 18 18 18 5 5 18 18 18 18 5 5 18 18 18 18 18 18 5
5 18 0 4 4 4 4 3 2 4 4 1 18 5 5 18 0 4 4 3 2 4 4 4 4 1 18 5
5 18 2 4 4 4 4 4 4 4 4 3 18 2 3 18 2 4 4 4 4 4 4 4 4 3 18 5
5 18 18 18 18 18 18 18 18 18 18 18 18 18 18 18 18 18 18 18 18 18 18 18 18 18 18 5
2 4 4 4 4 4 4 4 4 4 4 4 4 4 4 4 4 4 4 4 4 4 4 4 4 4 4 3
-1 -1 -1 -1 -1 -1 -1 -1 -1 -1 -1 -1 -1 -1 -1 -1 -1 -1 -1 -1 -1 -1 -1 -1 -1 -1 -1 -1
-1 -1 -1 -1 -1 -1 -1 -1 -1 -1 -1 -1 -1 -1 -1 -1 -1 -1 -1 -1 -1 -1 -1 -1 -1 -1 -1 -1
-1 -1 -1 -1 -1 -1 -1 -1 -1 -1 -1 -1 -1 -1 -1 -1 -1 -1 -1 -1 -1 -1 -1 -1 -1 -1 -1 -1
Pacman 13 25
Ghost   1  3
Ghost  26  3
Ghost   1 31
Ghost  26 31